{
  "map": [
    "1111111111111111111111",
    "110000000000000O00001",
    "101001010010000010100",
    "101001001010101000100",
    "110000000O00O00000001",
    "100000000000000000000",
    "100000000000000000000",
    "100000000000000000000",
    "100000000000000000000",
    "111111111111111111111"
  ]
}
